{
  "id": "caverns-8",
  "biome": "caverns",
  "cols": 12,
  "rows": 18,
  "rows_data": [
    "............",
    "............",
    "UU.UU..UU.UU",
    "UU.UU..UU.UU",
    "AA.AA..AA.AA",
    "AA.AA..AA.AA",
    "............",
    "............",
    "............",
    "............",
    "............",
    "............",
    "............",
    "............",
    "............",
    "............",
    "............",
    "............"
  ],
  "legend": {
    "A": "cavern_basic",
    "U": "cavern_union"
  }
}
