{
  "id": "caverns-6",
  "biome": "caverns",
  "cols": 12,
  "rows": 18,
  "rows_data": [
    "............",
    "............",
    ".AAA.AA.AAA.",
    ".AMA.MM.AMA.",
    ".AAA.AA.AAA.",
    ".AAA....AAA.",
    "............",
    "............",
    "............",
    "............",
    "............",
    "............",
    "............",
    "............",
    "............",
    "............",
    "............",
    "............"
  ],
  "legend": {
    "A": "cavern_basic",
    "M": "cavern_bomb"
  }
}
