{
  "id": "caverns-4",
  "biome": "caverns",
  "cols": 12,
  "rows": 18,
  "rows_data": [
    "............",
    "...K....K...",
    "............",
    "AA...AA...AA",
    "AA...AA...AA",
    "AA...AA...AA",
    ".....AA.....",
    "............",
    "............",
    "............",
    "............",
    "............",
    "............",
    "............",
    "............",
    "............",
    "............",
    "............"
  ],
  "legend": {
    "A": "cavern_basic",
    "K": "cavern_stalactite"
  }
}
