{
  "id": "caverns-2",
  "biome": "caverns",
  "cols": 12,
  "rows": 18,
  "rows_data": [
    "............",
    "............",
    "AA.AA..AA.AA",
    "BB.BB..BB.BB",
    "AA.AA..AA.AA",
    "............",
    "............",
    "............",
    "............",
    "............",
    "............",
    "............",
    "............",
    "............",
    "............",
    "............",
    "............",
    "............"
  ],
  "legend": {
    "A": "cavern_basic",
    "B": "cavern_tough"
  }
}
