{
  "id": "heaven-4",
  "biome": "heaven",
  "cols": 12,
  "rows": 18,
  "rows_data": [
    ".....E......",
    "............",
    "..AAA..AAA..",
    "..AAA..AAA..",
    "..AAA..AAA..",
    "...A....A...",
    "............",
    "............",
    "............",
    "............",
    "............",
    "............",
    "............",
    "............",
    "............",
    "............",
    "............",
    "............"
  ],
  "legend": {
    "A": "heaven_basic",
    "E": "heaven_melee_statue"
  }
}
