{
  "id": "heaven-6",
  "biome": "heaven",
  "cols": 12,
  "rows": 18,
  "rows_data": [
    "............",
    ".M........M.",
    "...AAAAAA...",
    "..M.AAAA.M..",
    "...AAAAAA...",
    "....AAAA....",
    "............",
    "............",
    "............",
    "............",
    "............",
    "............",
    "............",
    "............",
    "............",
    "............",
    "............",
    "............"
  ],
  "legend": {
    "A": "heaven_basic",
    "M": "heaven_windmaster"
  }
}
