{
  "id": "village-4",
  "biome": "village",
  "cols": 12,
  "rows": 18,
  "rows_data": [
    "............",
    ".....E......",
    "............",
    ".AAA....AAA.",
    ".AYA....AYA.",
    ".AAA....AAA.",
    "............",
    "............",
    "............",
    "............",
    "............",
    "............",
    "............",
    "............",
    "............",
    "............",
    "............",
    "............"
  ],
  "legend": {
    "A": "village_basic",
    "Y": "village_basic2",
    "E": "village_beholder"
  }
}
